111111
100001
101C01
1000P1
111111
