111111
1E0101
101C01
1000P1
111111
