11111111111111111111111111
1C01010E00000C000000011111
11100100001111111111111111
1000P0000000000000C0000001
11111111111111111111111111
