11111111111111111111111111
1E010100000000000000011111
10100100001111111111111111
1000P000000000000000000001
11111111111111111111111111
