1110111111111
10010000000C1
1000011110111
1P0011E000C01
1111111111111
