1111111111111111111111111111
1P0E0C0000000011111111111111
111111100000000000000C00C001
1111111111111111111111111111
