11111111111111111111111111111111111111111111111111111111111111111111111111
10010000000C1111111111111111111000000000000000000000000000000CCCCCC1111111
10000111101110000000000000000000001111100000111100000000000000000000000001
1P0011E000C000000000000000000000000111111111111111111111111100001111111111
11111111111111111111111111111111111111111111111111111111111111111111111111
