11111111111111111111111111
1E010100P00000000000011111
10100100001111111111111111
1000P0000000000000C0000001
11111111111111111111111111
