1111111111111111111111111111
1P0E0C0000080011111111111111
11111110000a000000000C00C001
1111111111111111111111111111
