1111111111111111111111111111
100E0C0000000011111111111111
111111100000000000000C01P001
1111111111111111111111111111
