1111111111111111111111111111
1P000C0000000011111111111111
111111100000000000000C01E001
1111111111111111111111111111
